FILE	NOM	file
PERS_NAME	NAM	<unknown>
PROF_INSEE	NAM	<unknown>
NIV_ETUDES	NOM	<unknown>
TEXT	VER:subi	<unknown>
./ESLO2_ENT_1001_C.tei_corpo.xml	ADJ	<unknown>
ch_OB1	NOM	<unknown>
Cadres	NOM	cadre
et	KON	et
professions	NOM	profession
intellectuelles	ADJ	intellectuel
supérieures	ADJ	supérieur
Bac	NOM	bac
+	SYM	+
5	NUM	@card@
et	KON	et
plus	ADV	plus
mais	KON	mais
ça	PRO:DEM	cela
ne	ADV	ne
serait	VER:cond	être
pas	ADV	pas
non	ADV	non
plus	ADV	plus
./ESLO2_ENT_1004_C.tei_corpo.xml	NAM	<unknown>
ZF4	NAM	<unknown>
Retraités	ADJ	retraité
Bac	NOM	bac
alors	ADV	alors
on	PRO:PER	on
ne	ADV	ne
lui	PRO:PER	lui
a	VER:pres	avoir
pas	ADV	pas
mis	VER:pper	mettre
une	DET:ART	un
chaise	NOM	chaise
